главное	ADV
на самом деле	W
тем самым	W
при этом	W
скорее всего	W
в основном	W
вместе с тем	W
следовательно	ADV
так	ADV
видимо	ADV
более	ADV
разумеется	ADV
среди прочего	W
наиболее	ADV
к примеру	W
то есть	ADV
может быть	W
кроме того	W
кроме этого	W
все-таки	PART
по меньшей мере	ADV
по крайней мере	ADV
и так далее	ADV
в том числе	PART
что называется	W
наверное	ADV
вместо этого	W
тем не менее	ADV
как и ожидалось	W
таким образом	W
правда	ADV
однако	ADV
кстати	ADV
в частности	ADV
впрочем	ADV
в некотором роде	W
так вот	W
надо полагать	W
не в последнюю очередь	W
стало быть	W
как и следовало ожидать	W
кстати говоря	W
короче говоря	W
и т.д.	W
и т.д	W
в большинстве	W
и т.п	W
и пр	W
и пр.	W
к тому же	W
кроме прочего	W
кроме всего прочего	W
всего лишь	W
во всяком случае	W
вроде как	W
вроде бы	W
главным образом	W
на деле	W
и прочее	W
в принципе	W
опять же	W
помимо этого	W
помимо того	W
помимо прочего	W
помимо всего прочего	W
спору нет	W
больше всего	W
иными словами	W
в лучшем случае	W
в любом случае	W
должно быть	W
более того	W
так или иначе	W
так сказать	W
к слову	W
по сути	W
по сути дела	W
самое главное	W
еще бы	W
в общем	W
в довершение всего	W
выходит	VERB
итак	ADV
типа	NOUN
пожалуй	ADV
по-моему	ADV
собственно	ADV
точнее	ADV
бывает	VERB
дескать	ADV
менее	ADV
наконец	ADV
притом	ADV
по-нашему	ADV
скажем	VERB
по-видимому	ADV
видно	ADV
может	VERB
допустим	VERB
предположим	VERB
известно	ADV
значит	ADV
словом	ADV
наименее	ADV
понятно	ADV
конечно	ADV
все же	PART
все равно	ADV
хотя бы	PART
нон грата	W
4.	NUM
7200.11.	NUM
(495)	NUM
таки	PART
в особенности	ADV
во многом	ADV
аналогичным образом	ADJ
в сущности	W
в своем роде	W